Bloki ========================= 16 - coin, 17 - drzwi, 19 - kolce
18
15
0 16 0 0 0 0 19 0 0 0 0 0 0 0 0 0 0 16
0 0 0 0 0 0 8 10 0 0 0 0 0 0 0 0 8 10
0 0 0 0 0 0 0 0 0 0 0 0 0 0 0 0 0 0
8 9 9 10 0 0 0 0 0 0 0 0 0 0 0 0 0 0
0 0 0 0 0 0 0 0 0 0 0 0 0 0 0 0 0 17
0 0 0 0 0 0 0 0 0 0 0 0 0 0 0 8 9 10
0 16 0 0 0 6 0 0 0 0 0 0 0 0 0 0 0 0
0 0 0 0 0 0 0 0 0 0 0 0 0 0 0 0 0 0
0 8 9 10 0 0 0 0 0 0 0 0 8 9 10 0 16 0
0 0 0 0 0 0 0 8 9 10 0 0 0 0 0 0 0 0
0 0 0 0 0 0 0 0 0 0 0 0 0 0 0 0 0 0
0 0 0 0 0 0 0 0 0 0 0 0 0 0 0 0 0 0
0 0 0 0 0 0 0 0 0 0 0 0 0 0 0 0 0 0
0 0 0 0 0 0 0 0 0 0 0 0 0 0 0 0 0 0
19 19 19 19 19 19 19 19 19 19 19 19 19 19 19 19 19 19
Ruszajace sie bloki ===========
1
8 1 6 8 16