Bloki ========================= 16 - coin, 17 - drzwi, 19 - kolce
18
15
0 0 0 0 0 0 0 19 0 0 0 19 0 0 0 0 16 0
0 0 0 0 0 0 0 0 0 0 0 0 0 0 0 0 13 15
0 0 0 0 0 0 0 0 0 0 0 0 0 0 0 0 0 0
13 14 15 0 0 0 0 0 0 0 0 0 0 0 0 0 0 0
0 0 0 0 0 0 0 0 0 0 0 0 0 0 0 0 0 17
0 0 0 0 0 0 0 0 0 0 0 0 0 0 0 0 13 15
0 0 0 0 0 0 0 0 0 0 0 0 0 0 0 0 0 0
0 16 19 0 0 0 0 0 0 0 0 0 0 0 0 0 0 0
0 13 15 0 0 0 0 0 0 0 0 0 0 0 16 0 0 0
0 0 0 0 0 0 0 0 0 0 0 0 0 0 11 0 0 0
0 0 0 0 0 0 0 0 0 0 0 0 0 0 0 0 0 0
0 0 0 0 0 0 0 0 0 0 0 0 0 0 0 0 0 0
0 0 0 0 0 0 0 0 0 0 0 0 0 0 0 0 0 0
0 0 0 0 0 0 0 0 0 0 0 0 0 0 0 0 0 0
19 19 19 19 19 19 19 19 19 19 19 19 19 19 19 19 19 19
Ruszajace sie bloki ===========
2
15 1 11 5 14
9 6 11 5 12